/----------------------------\
(                            )
(                            )
(                            )
(                            )
(                            )
(                            )
(                            )
(                            )
(                            )
(                            )
(                            )
(                            )
(                            )
(                            )
(                            )
 ____________________________ 
