/----------------------------\
(                            )
(                            )
(                            )
(                            )
(                            )
(                            )
(                            )
(                            )
(                            )
(                            )
(                            )
(                            )
(                            )
(                            )
o____________________________e
