/----------------------------\
(                            )
(                            )
(                       a    )
(                            )
(                            )
(                            )
(           ggg              )
(           ggg              )
(           ggg              )
(                            )
(                            )
(                    xx      )
(                    xx      )
(                            )
o____________________________e
